Num robots 18
Information for current graph
Dimension: 11 x 11
OOOOOOOOOOO
OOOOOOOOOOO
OOXOOXOOXOO
OOOOOOOOOOO
OOOOOOOOOOO
OOXOOXOOXOO
OOOOOOOOOOO
OOOOOOOOOOO
OOXOOXOOXOO
OOOOOOOOOOO
OOOOOOOOOOO

Start configuration:
               (3, 3)               (6, 3)               (6, 7)               (1, 7)               (6, 5)               (9, 2)               (9, 8)               (3, 8)               (6, 1)               (8, 1)               (3, 5)               (5, 7)               (1, 4)               (9, 4)               (6, 4)               (3, 1)               (8, 7)               (8, 4)
Goal configuration:
               (2, 1)               (6, 4)               (7, 8)               (7, 1)               (9, 3)               (5, 1)               (3, 4)               (9, 5)               (1, 4)               (6, 2)               (9, 8)               (3, 8)               (6, 7)               (3, 9)               (1, 1)               (6, 8)               (9, 4)               (4, 5)
Solution:
               (3, 3)               (6, 3)               (6, 7)               (1, 7)               (6, 5)               (9, 2)               (9, 8)               (3, 8)               (6, 1)               (8, 1)               (3, 5)               (5, 7)               (1, 4)               (9, 4)               (6, 4)               (3, 1)               (8, 7)               (8, 4)
               (3, 2)               (6, 4)               (6, 8)               (1, 6)               (6, 5)               (9, 1)               (9, 7)               (3, 7)               (6, 2)               (7, 1)               (3, 6)               (4, 7)               (1, 5)               (9, 5)               (7, 4)               (4, 1)               (8, 6)               (8, 4)
               (3, 2)               (5, 4)               (7, 8)               (0, 6)               (6, 5)               (8, 1)               (9, 6)               (3, 6)               (6, 2)               (7, 2)               (4, 6)               (3, 7)               (1, 6)               (10, 5)               (7, 3)               (4, 2)               (8, 6)               (8, 4)
               (3, 1)               (6, 4)               (7, 8)               (1, 6)               (6, 5)               (7, 1)               (9, 6)               (4, 6)               (6, 2)               (7, 2)               (4, 7)               (3, 6)               (1, 7)               (10, 6)               (6, 3)               (3, 2)               (8, 6)               (7, 4)
               (3, 1)               (6, 4)               (7, 8)               (1, 5)               (6, 5)               (6, 1)               (9, 5)               (5, 6)               (6, 2)               (7, 3)               (5, 7)               (3, 7)               (1, 7)               (9, 6)               (6, 3)               (3, 3)               (8, 6)               (7, 4)
               (2, 1)               (6, 3)               (7, 8)               (1, 4)               (6, 5)               (5, 1)               (9, 5)               (6, 6)               (6, 2)               (7, 4)               (6, 7)               (3, 8)               (2, 7)               (9, 7)               (7, 3)               (3, 4)               (9, 6)               (6, 4)
               (2, 1)               (7, 3)               (7, 8)               (1, 3)               (6, 5)               (5, 1)               (9, 4)               (7, 6)               (6, 3)               (7, 4)               (7, 7)               (3, 8)               (3, 7)               (9, 8)               (7, 2)               (3, 5)               (9, 5)               (6, 4)
               (2, 1)               (7, 2)               (7, 8)               (1, 2)               (6, 5)               (5, 1)               (8, 4)               (8, 6)               (6, 4)               (7, 3)               (8, 7)               (3, 8)               (4, 7)               (9, 9)               (6, 2)               (3, 6)               (9, 4)               (7, 4)
               (2, 1)               (7, 2)               (7, 8)               (1, 1)               (6, 5)               (5, 1)               (8, 4)               (9, 6)               (6, 3)               (7, 3)               (9, 7)               (3, 8)               (5, 7)               (8, 9)               (6, 2)               (3, 7)               (9, 4)               (7, 4)
               (2, 0)               (6, 2)               (7, 8)               (2, 1)               (6, 5)               (5, 1)               (8, 4)               (9, 5)               (7, 3)               (7, 2)               (9, 8)               (3, 8)               (6, 7)               (7, 9)               (6, 3)               (4, 7)               (9, 4)               (6, 4)
               (2, 1)               (6, 3)               (7, 8)               (3, 1)               (6, 5)               (5, 1)               (8, 4)               (9, 5)               (7, 4)               (6, 2)               (9, 8)               (3, 8)               (6, 7)               (6, 9)               (7, 3)               (5, 7)               (9, 4)               (6, 4)
               (2, 1)               (7, 3)               (7, 8)               (4, 1)               (6, 5)               (5, 1)               (8, 4)               (9, 5)               (6, 4)               (6, 2)               (9, 8)               (3, 8)               (6, 6)               (5, 9)               (7, 2)               (5, 7)               (9, 4)               (6, 3)
               (2, 1)               (7, 2)               (7, 8)               (4, 1)               (6, 5)               (5, 0)               (8, 4)               (9, 5)               (6, 4)               (6, 3)               (9, 8)               (3, 8)               (5, 6)               (4, 9)               (6, 2)               (6, 7)               (9, 4)               (7, 3)
               (2, 1)               (7, 3)               (7, 8)               (5, 1)               (6, 5)               (4, 0)               (8, 4)               (9, 5)               (6, 4)               (6, 2)               (9, 8)               (3, 8)               (5, 7)               (3, 9)               (7, 2)               (6, 8)               (9, 4)               (7, 4)
               (2, 1)               (8, 3)               (7, 8)               (6, 1)               (6, 4)               (4, 1)               (7, 4)               (9, 5)               (5, 4)               (6, 2)               (9, 8)               (3, 8)               (6, 7)               (3, 9)               (7, 1)               (6, 8)               (9, 4)               (7, 3)
               (2, 1)               (9, 3)               (7, 8)               (6, 0)               (6, 3)               (5, 1)               (7, 3)               (9, 5)               (4, 4)               (6, 2)               (9, 8)               (3, 8)               (6, 7)               (3, 9)               (6, 1)               (6, 8)               (8, 4)               (8, 3)
               (2, 1)               (9, 4)               (7, 8)               (7, 0)               (7, 3)               (5, 1)               (7, 4)               (9, 5)               (3, 4)               (6, 1)               (9, 8)               (3, 8)               (6, 7)               (3, 9)               (6, 0)               (6, 8)               (8, 3)               (9, 3)
               (2, 1)               (8, 4)               (7, 8)               (7, 1)               (7, 3)               (5, 1)               (6, 4)               (9, 5)               (2, 4)               (6, 2)               (9, 8)               (3, 8)               (6, 7)               (3, 9)               (6, 1)               (6, 8)               (9, 3)               (9, 4)
               (2, 1)               (8, 3)               (7, 8)               (7, 1)               (7, 3)               (5, 0)               (5, 4)               (9, 5)               (1, 4)               (6, 2)               (9, 8)               (3, 8)               (6, 7)               (3, 9)               (5, 1)               (6, 8)               (9, 4)               (8, 4)
               (2, 1)               (8, 4)               (7, 8)               (7, 1)               (8, 3)               (5, 1)               (4, 4)               (9, 5)               (1, 4)               (6, 2)               (9, 8)               (3, 8)               (6, 7)               (3, 9)               (4, 1)               (6, 8)               (9, 4)               (7, 4)
               (2, 1)               (7, 4)               (7, 8)               (7, 1)               (9, 3)               (5, 1)               (3, 4)               (9, 5)               (1, 4)               (6, 2)               (9, 8)               (3, 8)               (6, 7)               (3, 9)               (3, 1)               (6, 8)               (9, 4)               (6, 4)
               (2, 0)               (6, 4)               (7, 8)               (7, 1)               (9, 3)               (5, 1)               (3, 4)               (9, 5)               (1, 4)               (6, 2)               (9, 8)               (3, 8)               (6, 7)               (3, 9)               (2, 1)               (6, 8)               (9, 4)               (5, 4)
               (2, 1)               (6, 4)               (7, 8)               (7, 1)               (9, 3)               (5, 1)               (3, 4)               (9, 5)               (1, 4)               (6, 2)               (9, 8)               (3, 8)               (6, 7)               (3, 9)               (1, 1)               (6, 8)               (9, 4)               (4, 4)
               (2, 1)               (6, 4)               (7, 8)               (7, 1)               (9, 3)               (5, 1)               (3, 4)               (9, 5)               (1, 4)               (6, 2)               (9, 8)               (3, 8)               (6, 7)               (3, 9)               (1, 1)               (6, 8)               (9, 4)               (4, 5)

E:\myCode\ddm\DDM\x64\Release\DDM.exe (process 3724) exited with code 0.
To automatically close the console when debugging stops, enable Tools->Options->Debugging->Automatically close the console when debugging stops.
Press any key to close this window . . .
